####    _
8 ## ####
# ##  ###
#   # ###
### #   #
### ### #
#   ##  #
# #### ##
#      ##
#########
