#########
8### ## _
      # #
##### # #
####  # #
#### ## #
####  # #
##### # #
#####   #
#########
