####             #
8 ## ######## ####
# ##  #### #   ###
#   # ####   #####
### #   #### #   #
### ### #### ### #
#   ##  ##   ##  _
# #### ### #### ##
#      ###      ##
##################
