####################
##        #####   ##
8  ###### ##    # ##
########  ## #### ##
##       ###  ### ##
## ########## ###  #
##  ########  #### #
### #######  ####  #
### ####### ##### ##
###  ###### ####  ##
#### ###### #### ###
####   ###  ###  ###
###### ### #### ####
#      ### #### ####
  ######   ###  ####
 ####### ####  #####
  ###### #### ######
# ###### ####      _
         ###########
####################
